1 3 9 6 2 4 7 8 5
8 5 6 7 3 9 2 4 1
4 7 2 5 1 8 3 9 6
6 9 5 1 4 3 8 2 7
2 1 7 8 9 6 5 3 4
3 8 4 2 7 5 1 6 9
7 4 8 3 6 1 9 5 2
9 2 3 4 5 7 6 1 8
5 6 1 9 8 2 4 7 3