0 0 0 5 3 0 0 9 1
0 0 2 0 0 0 0 3 0
3 7 0 0 8 4 2 0 5
0 5 0 6 9 0 4 0 2
0 9 0 4 0 1 0 7 0
4 0 1 0 2 8 0 5 0
9 0 4 3 1 0 0 8 6
0 8 0 0 0 0 3 0 0
6 3 0 0 4 9 0 0 0