9 0 8 0 3 0 6 0 0
0 0 0 8 0 0 0 4 0
0 0 0 0 2 1 0 5 0
6 1 3 0 0 0 0 0 4
0 0 0 6 0 9 0 0 0
8 0 0 0 0 0 5 1 6
0 4 0 3 6 0 0 0 0
0 2 0 0 0 8 0 0 0
0 0 6 0 4 0 3 0 5