8 4 6 5 3 2 7 9 1
5 1 2 9 7 6 8 3 4
3 7 9 1 8 4 2 6 5
7 5 8 6 9 3 4 1 2
2 9 3 4 5 1 6 7 8
4 6 1 7 2 8 9 5 3
9 2 4 3 1 7 5 8 6
1 8 7 2 6 5 3 4 9
6 3 5 8 4 9 1 2 7