9 5 8 7 3 4 6 2 1
2 3 1 8 5 6 7 4 9
4 6 7 9 2 1 8 5 3
6 1 3 5 8 2 9 7 4
5 7 4 6 1 9 2 3 8
8 9 2 4 7 3 5 1 6
7 4 9 3 6 5 1 8 2
3 2 5 1 9 8 4 6 7
1 8 6 2 4 7 3 9 5